8 10 3 2 3 3 0 0 3 4
W W W W W W W W W W 
W . . . . W G . E W 
W . W W W W W W . W 
W . W . P C W W E W 
W . W . . . W . . W 
W . W . . . W C W W 
W . W . E . W . E W 
W . W W W . W W . W 
W . . . . . . . . W 
W W W W W W W W W W 
W W W W W W . . . . 
W . . . . W . . . . 
W . W W W W . . . . 
W . W . P C . . . . 
W . W . . . W . . . 
W . W . . . W . . . 
W . W . E E W . . . 
W . W W W . W . . . 
W . . . . . . . . . 
W W W W W W W . . . 
