W W W W W W W W W W 
W . . . C W G . . W 
W E W W W W W W . W 
W . W C . . W W E W 
W . W . . . W . . W 
W . W . . . W . W W 
W . W . E . W . E W 
W . W W W . W W . W 
W P . . . . . . . W 
W W W W W W W W W W 